################################
#1.............##..............#
#..............##..............#
#..##########..##..............#
#..#...........##..............#
#..#...........##..............#
#..########....##..............#
#..#...........##..............#
#..#...........##..............#
#..#...........##..............#
#..............##..............#
#..............##..............#
#..............##..............#
#..............##..............#
#..............##..............#
################...............#
#..............................#
#..............................#
#..............................#
#..............................#
#..............................#
#..............................#
#..............................#
#..............................#
#..............................#
#..............................#
#..............................#
#..............................#
#..............................#
#..........................2...#
#..............................#
################################
